WWWWWWWWWWWWWWWWWWWW
WGWGGGGGGWWGGGGGGGWW
WGGGGGGGGWWGGGGGGGGW
WGGGGGGGGWWGGGGGGGGW
WGGGGGGGGGGGGGGGGGGW
WGGGGGGGGGGGGGGGGGGW
WGGGGGGGGGGGGGGGGGGW
WGGGGGGGGGGGGGGGGGGW
WGGGGGGRBBGGGGGGGGWW
WGGGGGGRBDGGGGGGGWWW
WGGGGGGRBBGGGGGGGGGW
WGGGGGGGGGGGGGGGGGGW
WGGGGGGGGGGGGGGGGGGW
WGGGGGGGGGGGGGGGGGGW
WGGGGGGGGGGGGGGGGGGW
WGGGGGGGGGGGGGGGGGGW
WGGGGGGGGGGGGGGGGGGW
WGGGGGGGGGGGGGGGGGGW
WGGGGGGGGGGGGGGGGGGW
WWWWWWWWWWWWWWWWWWWW

